70,40,5,1,1,0,0,-30,0,1,0,0
15,20,30,1,1,-60,-20,0,0,1,0,0
15,30,30,1,1,-15,10,0,0,1,0,0
15,30,30,1,1,30,-10,0,0,1,0,0
25,20,10,1,1,-45,20,20,0,1,0,0
35,10,10,1,1,-15,-30,-20,0,1,0,0
40,10,10,1,1,30,30,20,0,1,0,0
